111111111
1000000P1
1CCCCCCC1
1C0000001
1CCCCCCC1
1E00000C1
1CCCCCCC1
111111111