111111111111111
111C11C1E11P001
111111111111111