111111111111111
1000C000000P001
100E00000000001
111111111111111