111111111111111
1000C0C0000P001
100E00000000001
100000001111111
111111111111111